#############################
#1111#11111111#11##111411111#
#1111211####11311##111411111#
#1#11211####1131111111#11111#
#1#1121111111131111111411111#
#1#1111111111111111111111111#
#############################
