#############
#11111111111#
#1111##11111#
#1111##11111#
#1#####11111#
#11111111111#
#############
